##########
#S      #
#        # 
#  ###    #
#        #
#####    #
#       #
#    ##### 
#     E #
#       #
##########