#####  ###### #
#S             
#  #########   
#  #       #   
#  #  ###  #   
#  #  #E#  #   
#  #### ###  # 
#            # 
#####  ########