#####
#S###
#####
##E##
#####
