#####
#   #
#  ##
#  ##
#####
#####
#   #
#  ##
#  ##
#####
#####
#   #
#  ##
#  ##
#####
#####
#   #
# E##
#  ##
#####
#####
#   #
#  ##
# S##
#####
#####
#   #
#  ##
#  ##
#####
#####
#   #
#  ##
#  ##
#####
#####
#   #
#  ##
#  ##
#####
#####
#   #
#  ##
#  ##
#####
#####
#   #
#  ##
#  ##
#####
#####
#   #
#  ##
#  ##
#####
#####
#   #
#  ##
#  ##
#####
#####
#   #
#  ##
#  ##
#####
#####
#   #
#  ##
#  ##
#####
#####
#   #
#  ##
#  ##
#####
#####
#   #
#  ##
#  ##
#####
#####
#   #
#  ##
#  ##
#####
#####
#   #
#  ##
#  ##
#####
#####
#   #
#  ##
#  ##
#####
#####
#   #
#  ##
#  ##
#####
#####
#   #
#  ##
#  ##
#####
#####
#   #
#  ##
#  ##
#####
#####
#   #
#  ##
#  ##
#####
