########################################################################################################################################################################################################
####################S                                            ####################               ####################################################################################################
####################                                        ############################################################################################################################################
####################                    E    ########################################               ####################################################################################################
########################################################################################################################################################################################################
