#####
#SQ #
#  ##
# E##
#####
